
BOSSEnsemble = >	sktime.classification.dictionary_based._boss.BOSSEnsemble
ColumnEnsembleClassifier = >	sktime.classification.compose._column_ensemble.ColumnEnsembleClassifier
ComposableTimeSeriesForestClassifier = >	sktime.classification.compose._ensemble.ComposableTimeSeriesForestClassifier
ContractableBOSS = >	sktime.classification.dictionary_based._cboss.ContractableBOSS
ElasticEnsemble = >	sktime.classification.distance_based._elastic_ensemble.ElasticEnsemble
HIVECOTEV1 = >	sktime.classification.hybrid._hivecote_v1.HIVECOTEV1
IndividualBOSS = >	sktime.classification.dictionary_based._boss.IndividualBOSS
IndividualTDE = >	sktime.classification.dictionary_based._tde.IndividualTDE
KNeighborsTimeSeriesClassifier = >	sktime.classification.distance_based._time_series_neighbors.KNeighborsTimeSeriesClassifier
MUSE = >	sktime.classification.dictionary_based._muse.MUSE
MrSEQLClassifier = >	sktime.classification.shapelet_based.mrseql.mrseql.MrSEQLClassifier
ProximityForest = >	sktime.classification.distance_based._proximity_forest.ProximityForest
ProximityStump = >	sktime.classification.distance_based._proximity_forest.ProximityStump
ProximityTree = >	sktime.classification.distance_based._proximity_forest.ProximityTree
ROCKETClassifier = >	sktime.classification.shapelet_based._rocket_classifier.ROCKETClassifier
RandomIntervalSpectralForest = >	sktime.classification.interval_based._rise.RandomIntervalSpectralForest
ShapeDTW = >	sktime.classification.distance_based._shape_dtw.ShapeDTW
ShapeletTransformClassifier = >	sktime.classification.shapelet_based._stc.ShapeletTransformClassifier
SupervisedTimeSeriesForest = >	sktime.classification.interval_based._stsf.SupervisedTimeSeriesForest
TemporalDictionaryEnsemble = >	sktime.classification.dictionary_based._tde.TemporalDictionaryEnsemble
TimeSeriesForestClassifier = >	sktime.classification.interval_based._tsf.TimeSeriesForestClassifier
WEASEL = >	sktime.classification.dictionary_based._weasel.WEASEL)
